|------|   
|      0   
|     -|-  
|      |   
|__   / \  
